35 25
11111111111111111111111111111111111
10000000000000000000000000000000001
10000000000000000000000000000000001
10000000000000000000000000000000001
10000000000000000000000000000000001
10000000000000000000000000000000001
10000000000000000000000000000000001
10002200000000000000000000000000001
10000000000000000000000000000000001
10000000002200000000000000000000001
10000000000000000000000000000000001
10000000000000220000000000000000001
10000000000000000000000000000000001
10000000000000000022000000000000001
10000000000000000000000000000000001
10000000000000000000002200000000001
10000000000000000000000000000000001
10000000000000000000000000220000001
10000000000000000000000000000000001
10000000000000000000000000000222001
10000000000000000000000000000000001
10000000000000000000000000000000001
10000000000000000000000000000000001
11111111111111111111111111111111111
11111111111111111111111111111111111
SPAWN 80 100
PORTAL 520 300 32 48 ../levels/level1.txt 80 400
